**********************
*   xxx              *
*   x x   xxxSxxxx   *
*   xxxxxxx      x   *
*  xx x xxxxxx   x   *
*   x x xxx      x   *
*   x            x   *
*   x            x   *
*   xxxxxxxxxxxxxx   *
*                    *
*                    *
**********************
