 ********************************************
0*       x                                  *
1*       x                                  *
2*       x                                  *
3*       x                                  *
4*       x                                  *
5*       x                                  *
6*       x                     xxxxxxxxxxxxx*
7*       x                     x            *
8*       x                     x            *
9*       x                     x            *
0*       xxxxxxxxxxxxxxxxxxxxxxx            *
1*                             x            *
2*                             x            *
3*                             x            *
4*                             x            *
5*                             x            *
6*                             x            *
7*                             x            *
8*                             x            *
9*                             x            *
 ********************************************
  012345678901234567890123456789012345678901
  0         1         2         3         4
